1111111111111
1T010000000C1
1000011110001
1P0011E000101
1111111111111