1111111111111
10E1000000001
10C001111100
10P0110001001
1111111111111