1111111111111111111111111
1PEC000000000000000000001
1000000000000000000000C01
100000000C000000000000001
100000000000000C000000001
10000000C0000000000000001
1000000000C00000000000001
10000C0000000000000000001
1000000000000C00000C00001
1000000000000000000000001
100000C000000000000000001
10000000000000000000C0001
100000000000000C000000001
1000000000000000000000001
1111111111111111111111111